########################################
#           #                         ##
#           # ####################### ##
#           # #                     # ##
#           # #                     # ##
#  ########## #                     # ##
#  #          #                     # ##
#  # ##########                     # ##
#  # #        ####################### ##
#  # #        #+                      ##
#  # #        ############ ########## ##
#  # #            #                   ##
#  # #            # ####################
#  # #            #        #           #
#  # #           ######### #           #
#  # #                   # #           #
#  # #                   # #           #
#  ####################### #           #
#  #                       #           #
####.###################################