########################################
#                                      #
#   ################                   #
#   #+             #                   #
#   ######## #######                   #
#          # #                         #
#          # #    ###                  #
#          # #    # ###########        #
#          # #    #           #        #
#          # #    # ###########        #
#  ######### ###### ####################
#  #                                   #
#  # ############## ####################
#  # #            # #                  #
####.###################################