########################################
#                                      #
#   ################                   #
#   #+------|      #                   #
#   ########|#######                   #
#          #|#                         #
#          #|#    ###                  #
#          #|#    # ###########        #
#          #|#    #           #        #
#          #|#    # ###########        #
#  #########|###### ####################
#  #|--------                          #
#  #|############## ####################
#  #|#            # #                  #
####.###################################