########################################
#           #                         ##
#           # ####################### ##
#           # #                     # ##
#           # #                     # ##
#  ########## #                     # ##
#  #          #                     # ##
#  # ##########                     # ##
#  # #        ####################### ##
#  # #        #+----------|           ##
#  # #        ############|########## ##
#  # #            #|-------           ##
#  # #            #|####################
#  # #            #-------|#           #
#  # #           #########|#           #
#  # #                   #|#           #
#  # #                   #|#           #
#  #######################|#           #
#  #|----------------------#           #
####.###################################