########################################
#           #                         ##
#           # ####################### ##
#           # #            ###      # ##
#           # #            #+#      # ##
#  ########## #            #|#      # ##
#  #          #            #|#      # ##
#  # ##########            #|#      # ##
#  # #         #############|######## ##
#  # #         #|------------       # ##
#  # #         #|################## # ##
#  # #         #|#                #   ##
#  # #         #|#  ####################
#  # #         #|#  #-----|#           #
#  # #         #|####|####|#           #
#  # #         #-----|#  #|#           #
#  # #         ########  #|#           #
#  #######################|#           #
#  #|----------------------#           #
####.###################################