########################################
#           #                         ##
#           # ####################### ##
#           # #            ###      # ##
#           # #            #+#      # ##
#  ########## #            # #      # ##
#  #          #            # #      # ##
#  # ##########            # #      # ##
#  # #         ############# ######## ##
#  # #         #                    # ##
#  # #         # ################## # ##
#  # #         # #                #   ##
#  # #         # #  ####################
#  # #         # #  #      #           #
#  # #         # #### #### #           #
#  # #         #      #  # #           #
#  # #         ########  # #           #
#  ####################### #           #
#  #                       #           #
####.###################################